{
    "blocks": {
        "#": {
            "texture": "block_#_grass.png"
        }
    },
    "map": [
        " ############## ",
        "#              #",
        "#              #",
        "#   #      #   #",
        "#   ##    ##   #",
        "#              #",
        "#              #",
        "#  ##########  #",
        "#              #",
        "#              #",
        " ############## "
    ],
    "version": 1
}
